No. Data Points,Actual,cep,ecl-c,ecl-nc,lpv,rrlyr,All
-100 < 0,ecl-c,0,0,0,65,0,65
-100 < 0,ecl-nc,0,0,0,32,0,32
-100 < 0,lpv,0,0,0,34,0,34
-100 < 0,rrlyr,0,0,0,26,0,26
0 < 100,cep,658,23,12,21,53,767
0 < 100,ecl-c,37,6258,3082,662,316,10355
0 < 100,ecl-nc,37,1831,9117,761,277,12023
0 < 100,lpv,11,753,785,10682,89,12320
0 < 100,rrlyr,43,1134,475,170,6168,7990
100 < 200,cep,240,30,12,106,12,400
100 < 200,ecl-c,87,7558,2016,2748,259,12668
100 < 200,ecl-nc,32,1121,9609,3078,91,13931
100 < 200,lpv,9,366,576,6431,41,7423
100 < 200,rrlyr,33,727,460,727,1346,3293
1000 < 1100,cep,45,0,0,0,6,51
1000 < 1100,ecl-c,0,0,0,0,3,3
1000 < 1100,ecl-nc,0,0,0,0,2,2
1000 < 1100,lpv,0,0,0,297,2,299
1000 < 1100,rrlyr,2,0,0,0,653,655
1100 < 1200,cep,18,0,1,1,3,23
1100 < 1200,ecl-c,0,0,0,0,1,1
1100 < 1200,ecl-nc,1,0,0,0,0,1
1100 < 1200,lpv,0,0,0,214,3,217
1100 < 1200,rrlyr,4,1,0,0,432,437
1200 < 1300,cep,13,0,0,0,3,16
1200 < 1300,lpv,0,0,0,314,1,315
1200 < 1300,rrlyr,3,1,0,2,373,379
1300 < 1400,cep,7,0,0,0,1,8
1300 < 1400,ecl-c,0,1,0,0,3,4
1300 < 1400,ecl-nc,0,0,1,0,2,3
1300 < 1400,lpv,0,0,0,649,5,654
1300 < 1400,rrlyr,3,0,0,3,573,579
1400 < 1500,cep,1,0,0,0,1,2
1400 < 1500,ecl-c,0,2,0,0,10,12
1400 < 1500,ecl-nc,0,0,0,0,1,1
1400 < 1500,lpv,0,0,0,439,4,443
1400 < 1500,rrlyr,0,0,0,0,303,303
1500 < 1600,cep,1,0,0,0,0,1
1500 < 1600,lpv,0,0,0,27,0,27
1500 < 1600,rrlyr,1,0,0,1,49,51
1600 < 1700,cep,1,0,0,0,0,1
1600 < 1700,lpv,0,0,0,167,0,167
1600 < 1700,rrlyr,1,0,0,1,157,159
1700 < 1800,cep,0,0,0,0,1,1
1700 < 1800,lpv,0,0,0,123,2,125
1700 < 1800,rrlyr,0,0,0,2,78,80
1800 < 1900,lpv,0,0,0,78,0,78
1800 < 1900,rrlyr,0,0,0,0,55,55
1900 < 2000,lpv,0,0,0,11,0,11
1900 < 2000,rrlyr,0,0,0,1,12,13
200 < 300,cep,71,3,0,64,12,150
200 < 300,ecl-c,168,1380,167,2153,123,3991
200 < 300,ecl-nc,39,126,1215,2095,59,3534
200 < 300,lpv,3,24,85,2094,9,2215
200 < 300,rrlyr,60,58,9,655,504,1286
2000 < 2100,lpv,0,0,0,3,0,3
2000 < 2100,rrlyr,0,0,0,0,19,19
2100 < 2200,lpv,0,0,0,6,0,6
2100 < 2200,rrlyr,1,0,0,0,10,11
2200 < 2300,lpv,0,0,0,13,0,13
2200 < 2300,rrlyr,0,0,0,0,9,9
2300 < 2400,ecl-c,0,0,0,0,1,1
2300 < 2400,ecl-nc,0,0,0,0,1,1
2300 < 2400,lpv,0,0,0,84,0,84
2300 < 2400,rrlyr,0,0,0,0,63,63
2400 < 2500,lpv,0,0,0,10,0,10
2400 < 2500,rrlyr,0,0,0,1,7,8
2500 < 2600,cep,0,0,0,0,1,1
2500 < 2600,lpv,0,0,0,69,0,69
2500 < 2600,rrlyr,0,0,0,1,51,52
2600 < 2700,lpv,0,0,0,13,0,13
2600 < 2700,rrlyr,0,0,0,0,17,17
2700 < 2800,lpv,0,0,0,152,2,154
2700 < 2800,rrlyr,0,0,0,5,119,124
2800 < 2900,lpv,0,0,0,52,0,52
2800 < 2900,rrlyr,0,0,0,2,57,59
2900 < 3000,lpv,0,0,0,110,0,110
2900 < 3000,rrlyr,0,0,0,4,92,96
300 < 400,cep,1577,1,0,41,10,1629
300 < 400,ecl-c,235,1250,189,964,123,2761
300 < 400,ecl-nc,46,54,671,1032,43,1846
300 < 400,lpv,8,4,6,1787,5,1810
300 < 400,rrlyr,107,79,13,277,1473,1949
3000 < 3100,lpv,0,0,0,3,0,3
3000 < 3100,rrlyr,0,0,0,0,8,8
3100 < 3200,rrlyr,0,0,0,0,6,6
3200 < 3300,rrlyr,0,0,0,0,1,1
3300 < 3400,rrlyr,0,0,0,0,2,2
3400 < 3500,rrlyr,0,0,0,0,1,1
3500 < 3600,rrlyr,0,0,0,0,5,5
3600 < 3700,rrlyr,0,0,0,0,2,2
3700 < 3800,rrlyr,0,0,0,1,0,1
3900 < 4000,rrlyr,0,0,0,0,2,2
400 < 500,cep,228,2,1,289,152,672
400 < 500,ecl-c,74,202,0,332,53,661
400 < 500,ecl-nc,11,1,2,330,32,376
400 < 500,lpv,5,3,0,467,9,484
400 < 500,rrlyr,20,15,0,90,1828,1953
4000 < 4100,rrlyr,0,0,0,0,1,1
4100 < 4200,rrlyr,0,0,0,0,2,2
4600 < 4700,rrlyr,0,0,0,0,1,1
4800 < 4900,rrlyr,0,0,0,0,1,1
4900 < 5000,rrlyr,0,0,0,0,1,1
500 < 600,cep,284,0,0,7,7,298
500 < 600,ecl-c,42,10,0,76,45,173
500 < 600,ecl-nc,13,0,1,92,20,126
500 < 600,lpv,3,1,0,360,10,374
500 < 600,rrlyr,29,5,0,17,1771,1822
600 < 700,cep,583,0,0,8,9,600
600 < 700,ecl-c,37,271,3,30,71,412
600 < 700,ecl-nc,12,0,1,38,10,61
600 < 700,lpv,4,1,0,505,4,514
600 < 700,rrlyr,19,8,0,19,1349,1395
700 < 800,cep,313,0,1,2,13,329
700 < 800,ecl-c,34,151,0,14,69,268
700 < 800,ecl-nc,6,0,5,14,7,32
700 < 800,lpv,2,0,1,654,7,664
700 < 800,rrlyr,12,5,0,4,1432,1453
800 < 900,cep,409,0,2,19,52,482
800 < 900,ecl-c,22,378,0,11,101,512
800 < 900,ecl-nc,4,0,0,13,8,25
800 < 900,lpv,1,0,0,488,7,496
800 < 900,rrlyr,6,20,0,0,1078,1104
900 < 1000,cep,130,0,0,1,2,133
900 < 1000,ecl-c,0,79,0,1,32,112
900 < 1000,ecl-nc,0,0,1,0,4,5
900 < 1000,lpv,0,0,0,338,2,340
900 < 1000,rrlyr,3,0,0,4,837,844
All,,5909,23937,28519,43787,23255,125407
