No. Data Points,Actual,cep,ecl-c,ecl-nc,lpv,rrlyr,All
-100 < 0,ecl-c,0,0,0,65,0,65
-100 < 0,ecl-nc,0,0,0,32,0,32
-100 < 0,lpv,0,0,0,34,0,34
-100 < 0,rrlyr,0,0,0,26,0,26
0 < 100,cep,652,25,11,12,67,767
0 < 100,ecl-c,27,6090,3007,613,620,10357
0 < 100,ecl-nc,33,2069,8836,773,312,12023
0 < 100,lpv,16,721,927,10559,98,12321
0 < 100,rrlyr,44,1063,581,178,6124,7990
100 < 200,cep,244,36,14,83,23,400
100 < 200,ecl-c,292,7967,1965,1850,543,12617
100 < 200,ecl-nc,56,1273,9715,2749,138,13931
100 < 200,lpv,6,391,552,6710,31,7690
100 < 200,rrlyr,83,958,462,441,1349,3293
1000 < 1100,cep,45,0,0,0,6,51
1000 < 1100,ecl-c,0,0,0,0,3,3
1000 < 1100,ecl-nc,0,0,0,1,1,2
1000 < 1100,lpv,0,0,0,299,0,299
1000 < 1100,rrlyr,4,1,0,2,648,655
1100 < 1200,cep,16,1,0,1,5,23
1100 < 1200,ecl-c,0,0,0,0,1,1
1100 < 1200,ecl-nc,0,0,0,0,1,1
1100 < 1200,lpv,0,0,0,217,1,218
1100 < 1200,rrlyr,5,0,0,1,431,437
1200 < 1300,cep,14,0,0,1,1,16
1200 < 1300,lpv,0,0,0,315,0,315
1200 < 1300,rrlyr,3,1,0,5,370,379
1300 < 1400,cep,7,0,0,0,1,8
1300 < 1400,ecl-c,0,0,0,0,4,4
1300 < 1400,ecl-nc,0,0,0,2,1,3
1300 < 1400,lpv,0,0,0,653,1,654
1300 < 1400,rrlyr,1,0,0,1,577,579
1400 < 1500,cep,1,0,0,0,1,2
1400 < 1500,ecl-c,0,1,0,0,11,12
1400 < 1500,ecl-nc,0,0,1,0,0,1
1400 < 1500,lpv,0,0,0,442,1,443
1400 < 1500,rrlyr,0,0,0,0,303,303
1500 < 1600,cep,1,0,0,0,0,1
1500 < 1600,lpv,0,0,0,27,0,27
1500 < 1600,rrlyr,0,0,0,1,50,51
1600 < 1700,cep,0,0,0,0,1,1
1600 < 1700,lpv,0,0,0,167,0,167
1600 < 1700,rrlyr,0,0,0,0,159,159
1700 < 1800,cep,1,0,0,0,0,1
1700 < 1800,lpv,0,0,0,124,1,125
1700 < 1800,rrlyr,0,0,0,2,78,80
1800 < 1900,lpv,0,0,0,78,0,78
1800 < 1900,rrlyr,0,1,0,0,54,55
1900 < 2000,lpv,0,0,0,11,0,11
1900 < 2000,rrlyr,0,0,0,1,12,13
200 < 300,cep,78,2,0,53,17,150
200 < 300,ecl-c,285,1446,109,1702,481,4023
200 < 300,ecl-nc,23,107,1214,2076,114,3534
200 < 300,lpv,4,26,70,2317,12,2429
200 < 300,rrlyr,84,107,9,526,560,1286
2000 < 2100,lpv,0,0,0,3,0,3
2000 < 2100,rrlyr,0,0,0,1,18,19
2100 < 2200,lpv,0,0,0,6,0,6
2100 < 2200,rrlyr,0,0,0,1,10,11
2200 < 2300,lpv,0,0,0,11,2,13
2200 < 2300,rrlyr,0,0,0,0,9,9
2300 < 2400,ecl-c,0,0,0,0,1,1
2300 < 2400,ecl-nc,0,0,0,0,1,1
2300 < 2400,lpv,0,0,0,84,0,84
2300 < 2400,rrlyr,0,0,0,0,63,63
2400 < 2500,lpv,0,0,0,10,0,10
2400 < 2500,rrlyr,0,0,0,1,7,8
2500 < 2600,cep,1,0,0,0,0,1
2500 < 2600,lpv,0,0,0,69,0,69
2500 < 2600,rrlyr,0,0,0,1,51,52
2600 < 2700,lpv,0,0,0,12,1,13
2600 < 2700,rrlyr,0,0,0,0,17,17
2700 < 2800,lpv,0,0,0,154,0,154
2700 < 2800,rrlyr,0,0,0,4,120,124
2800 < 2900,lpv,0,0,0,52,0,52
2800 < 2900,rrlyr,0,0,0,0,59,59
2900 < 3000,lpv,0,0,0,110,0,110
2900 < 3000,rrlyr,0,0,0,7,89,96
300 < 400,cep,1587,2,0,29,11,1629
300 < 400,ecl-c,327,1284,182,773,185,2751
300 < 400,ecl-nc,34,94,639,1040,39,1846
300 < 400,lpv,12,0,8,1904,9,1933
300 < 400,rrlyr,128,177,18,228,1398,1949
3000 < 3100,lpv,0,0,0,3,0,3
3000 < 3100,rrlyr,0,0,0,0,8,8
3100 < 3200,rrlyr,0,0,0,1,5,6
3200 < 3300,rrlyr,0,0,0,0,1,1
3300 < 3400,rrlyr,0,0,0,0,2,2
3400 < 3500,rrlyr,0,0,0,0,1,1
3500 < 3600,rrlyr,0,0,0,0,5,5
3600 < 3700,rrlyr,0,0,0,1,1,2
3700 < 3800,rrlyr,0,0,0,0,1,1
3900 < 4000,rrlyr,0,0,0,0,2,2
400 < 500,cep,281,3,0,193,195,672
400 < 500,ecl-c,76,218,0,310,76,680
400 < 500,ecl-nc,4,1,11,355,5,376
400 < 500,lpv,5,1,1,552,5,564
400 < 500,rrlyr,22,29,1,79,1822,1953
4000 < 4100,rrlyr,0,0,0,0,1,1
4100 < 4200,rrlyr,0,0,0,0,2,2
4600 < 4700,rrlyr,0,0,0,0,1,1
4800 < 4900,rrlyr,0,0,0,0,1,1
4900 < 5000,rrlyr,0,0,0,0,1,1
500 < 600,cep,280,0,0,9,9,298
500 < 600,ecl-c,45,14,0,70,39,168
500 < 600,ecl-nc,7,2,2,111,4,126
500 < 600,lpv,5,0,0,390,5,400
500 < 600,rrlyr,20,19,2,23,1758,1822
600 < 700,cep,587,0,0,4,9,600
600 < 700,ecl-c,48,299,0,34,39,420
600 < 700,ecl-nc,9,0,1,46,5,61
600 < 700,lpv,1,1,0,521,1,524
600 < 700,rrlyr,19,31,1,11,1333,1395
700 < 800,cep,312,0,0,9,8,329
700 < 800,ecl-c,36,177,0,10,47,270
700 < 800,ecl-nc,4,1,1,18,8,32
700 < 800,lpv,1,0,0,661,5,667
700 < 800,rrlyr,9,29,0,9,1406,1453
800 < 900,cep,406,4,0,30,42,482
800 < 900,ecl-c,17,448,0,14,36,515
800 < 900,ecl-nc,4,0,1,16,4,25
800 < 900,lpv,1,2,0,493,3,499
800 < 900,rrlyr,7,61,0,4,1032,1104
900 < 1000,cep,127,0,0,1,5,133
900 < 1000,ecl-c,0,103,0,1,8,112
900 < 1000,ecl-nc,0,1,2,0,2,5
900 < 1000,lpv,0,1,0,336,3,340
900 < 1000,rrlyr,3,13,1,4,823,844
All,,6450,25301,28344,41969,24071,126135
